10 10
100000110E
0010000000
1010011011
0001110010
0110000000
0110010110
0000100000
1010101000
1011000111
S000000110
